ServerInput inputs/four_hard.swarm
timeLimitMin 6
numBuildings 4
polygonsPerBuilding 2 1 1 1
bldg1Bounds 50 35 -55 -70
bldg2Bounds 63 47 68 52
bldg3Bounds -30 -65 -40 -70
bldg4Bounds -25 -60 60 40
hqFeedFolder messageFeeds/hard1/
CameraHeight 300
DeviceWorkspaceScale 125
DeviceRadius 5
robotRadius 1.25
sensorRadius 6.5
SampleRate 0.1

1 1 46 3 30 50 -83 26 0
1 1 46 3 30 50 -79 38 0
1 1 46 3 30 50 -83 53 0
1 2 10 1 50 60 -50 61 0
1 3 28 2 60 75 -42 20 0
1 3 28 2 60 75 -29 27 0
1 12 26 2 200 220 -69 16 0
1 12 26 2 200 220 -58 27 0
1 13 10 1 215 225 -50 64 0
1 14 28 2 245 260 -10 43 0
1 14 28 2 245 260 -23 55 0
1 15 10 1 260 270 -26 24 0
1 22 10 1 270 280 -54 51 0
1 23 26 2 225 245 -46 33 0
1 23 26 2 225 245 -34 22 0
2 6 45 3 100 125 41 31 0
2 6 45 3 100 125 56 34 0
2 6 45 3 100 125 72 34 0
2 7 10 1 115 125 42 70 0
2 8 28 2 130 145 56 42 0
2 8 28 2 130 145 49 51 0
2 9 10 1 140 150 41 35 0
2 10 25 3 155 180 28 55 0
2 10 25 3 155 180 29 45 0
4 16 28 2 300 315 73 -10 0
4 16 28 2 300 315 73 -30 0
4 17 26 2 305 325 25 -39 0
4 17 26 2 305 325 18 -24 0
4 18 10 1 310 320 50 -75 0
4 19 28 2 320 335 62 -47 0
4 19 28 2 320 335 62 -34 0
4 20 46 3 340 360 71 -70 0
4 20 46 3 340 360 56 -68 0
4 20 46 3 340 360 44 -61 0
4 21 10 1 350 360 31 -40 0
