ServerInput inputs/four_hard.swarm
timeLimitMin 6
numBuildings 4
polygonsPerBuilding 2 1 1 1
bldg1Bounds 50 35 -55 -70
bldg2Bounds 63 47 68 52
bldg3Bounds -30 -65 -40 -70
bldg4Bounds -25 -60 60 40
hqFeedFolder messageFeeds/hard2/
CameraHeight 300
DeviceWorkspaceScale 125
DeviceRadius 5
robotRadius 1.25
sensorRadius 6.5
SampleRate 0.1

1 6 26 1 110 130 -37 21 0
1 6 26 1 110 130 -16 28 0
1 7 27 3 120 140 -47 56 0
1 7 27 3 120 140 -55 66 0
1 9 28 3 135 150 -25 45 0
1 9 28 3 135 150 -19 34 0
1 10 10 1 140 150 -63 34 0
1 11 30 2 155 170 -36 73 0
1 11 30 2 155 170 -20 65 0
3 13 28 2 190 205 -40 -29 0
3 13 28 2 190 205 -50 -17 0
3 14 46 3 210 230 -39 -60 0
3 14 46 3 210 230 -25 -41 0
3 14 46 3 210 230 -30 -54 0
3 15 28 1 230 245 -55 -21 0
3 15 28 1 230 245 -40 -13 0
3 16 10 2 250 260 -67 -30 0
4 1 10 1 10 20 22 -14 0
4 2 10 2 20 30 37 -14 0
4 3 10 2 30 40 40 -45 0
4 5 45 3 50 75 27 -21 0
4 5 45 3 50 75 25 -36 0
4 5 45 3 50 75 31 -12 0
4 17 28 2 280 295 43 -20 0
4 17 28 2 280 295 56 -23 0
4 19 46 3 300 320 39 -4 0
4 19 46 3 300 320 33 -14 0
4 19 46 3 300 320 33 -26 0
4 20 28 2 310 325 69 -38 0
4 20 28 2 310 325 82 -25 0
4 21 26 2 325 345 31 -8 0
4 21 26 2 325 345 24 -21 0
4 22 10 1 330 340 60 -61 0
4 23 10 1 345 355 26 -40 0
4 24 10 3 305 315 55 -62 0
