ServerInput inputs/single_practice.swarm
timeLimitMin 10
numBuildings 1
polygonsPerBuilding 1
bldg1Bounds 15 -15 15 -15
hqFeedFolder messageFeeds/single_practice/
CameraHeight 250
DeviceWorkspaceScale 80
DeviceRadius 5
robotRadius 1.25
sensorRadius 6.5
SampleRate 0.1

1 1 20 1 10 50 -25 28 0
1 1 20 1 10 50 -12 32 0
1 2 23 1 45 75 -18 -15 0
1 2 23 1 45 75 -19 -3 0
1 3 23 1 70 100 30 11 0
1 4 6 1 100 120 -21 -9 0
1 5 25 1 110 135 -15 17 0
1 5 25 1 110 135 -12 24 0
1 6 23 1 135 165 -21 -1 0
1 6 23 1 135 165 -29 12 0
1 7 5 1 165 190 -9 30 0
1 8 23 1 190 220 -31 -17 0
1 8 23 1 190 220 -33 -3 0
1 9 23 1 220 250 17 14 0
1 9 23 1 220 250 17 2 0
1 10 25 1 240 265 -6 22 0
1 11 10 1 265 275 -26 -16 0
1 12 45 1 275 300 8 -28 0
1 12 45 1 275 300 -5 -26 0
1 12 45 1 275 300 -17 -22 0
1 13 26 1 300 320 -6 28 0
1 13 26 1 300 320 4 19 0
1 14 25 1 320 345 19 6 0
1 14 25 1 320 345 18 -14 0
1 15 28 1 345 360 -33 -11 0
1 15 28 1 345 360 -24 -20 0
1 16 23 1 360 390 -25 17 0
1 16 23 1 360 390 -13 25 0
1 17 6 1 390 410 -2 16 0
