ServerInput inputs/single_hard.swarm
timeLimitMin 4
numBuildings 1
polygonsPerBuilding 1
bldg1Bounds 20 -20 10 -10
hqFeedFolder messageFeeds/single_hard1/
CameraHeight 250
DeviceWorkspaceScale 80
DeviceRadius 5
robotRadius 1.25
sensorRadius 6.5
SampleRate 0.1

1 1 26 1 10 30 -32 -18 0
1 1 26 1 10 30 -25 -9 0
1 2 5 1 20 45 21 20 0
1 3 25 1 30 55 -17 11 0
1 3 25 1 30 55 -17 -1 0
1 4 26 1 45 65 -22 -24 0
1 4 26 1 45 65 -5 -23 0
1 5 26 1 60 80 -6 39 0
1 5 26 1 60 80 -18 29 0
1 6 43 1 75 105 -29 -7 0
1 6 43 1 75 105 -22 -16 0
1 6 43 1 75 105 -15 -22 0
1 7 10 1 95 105 7 -3 0
1 8 25 1 100 125 -12 32 0
1 8 25 1 100 125 -3 33 0
1 9 23 1 120 150 -11 -29 0
1 9 23 1 120 150 -24 -32 0
1 10 8 1 130 145 -28 -15 0
1 11 25 1 150 175 2 24 0
1 11 25 1 150 175 14 34 0
1 12 8 1 180 195 -19 -12 0
1 13 28 1 185 200 12 -9 0
1 13 28 1 185 200 23 -1 0
1 14 6 1 200 220 -28 -31 0
1 15 25 1 215 240 -21 21 0
1 15 25 1 215 240 -21 38 0
