ServerInput inputs/single_hard.swarm
timeLimitMin 4
numBuildings 1
polygonsPerBuilding 1
bldg1Bounds 20 -20 10 -10
hqFeedFolder messageFeeds/single_hard2/
CameraHeight 250
DeviceWorkspaceScale 80
DeviceRadius 5
robotRadius 1.25
sensorRadius 6.5
SampleRate 0.1

1 1 26 1 10 30 -18 -7 0
1 1 26 1 10 30 -15 3 0
1 2 8 1 25 40 -12 35 0
1 3 25 1 45 70 27 8 0
1 3 25 1 45 70 20 -2 0
1 4 43 1 70 100 -15 -32 0
1 4 43 1 70 100 -6 -32 0
1 4 43 1 70 100 11 -32 0
1 5 10 1 75 85 -17 2 0
1 6 25 1 90 115 -17 -18 0
1 6 25 1 90 115 -26 -5 0
1 7 10 1 105 115 13 -8 0
1 8 26 1 115 135 -31 28 0
1 8 26 1 115 135 -15 28 0
1 9 26 1 130 150 -11 -27 0
1 9 26 1 130 150 -26 -22 0
1 10 26 1 150 170 -17 -9 0
1 10 26 1 150 170 -18 9 0
1 11 10 1 160 170 -15 34 0
1 12 10 1 170 180 11 -6 0
1 13 26 1 175 195 -18 -22 0
1 13 26 1 175 195 -16 -37 0
1 14 26 1 200 220 -28 19 0
1 14 26 1 200 220 -27 28 0
1 15 25 1 215 240 -19 -10 0
1 15 25 1 215 240 -23 -20 0
