ServerInput inputs/tutorial.swarm
timeLimitMin 15
numBuildings 2
polygonsPerBuilding 1 1
bldg1Bounds 25 10 -20 -75
bldg2Bounds -10 -50 75 50
hqFeedFolder messageFeeds/tutorial/
CameraHeight 300
DeviceWorkspaceScale 125
DeviceRadius 5
robotRadius 1.25
sensorRadius 6.5
SampleRate 1.0

1 1 9 2 465 480 -20 30 0
1 1 9 2 465 480 -30 34 0
1 2 4 1 830 850 -3 41 0
1 3 5 1 840 860 -34 9 0
1 4 5 1 860 880 -64 47 0
1 5 6 2 885 905 -51 32 0
1 5 6 2 885 905 -33 42 0
1 6 13 3 910 935 -76 9 0
1 6 13 3 910 935 -66 -5 0
1 6 13 3 910 935 -52 -13 0
1 7 7 2 979 1000 -20 5 0
1 7 7 2 979 1000 -35 -8 0
1 8 5 1 1000 1020 -44 38 0
1 9 7 2 1010 1040 -5 24 0
1 9 7 2 1010 1040 -5 11 0
1 10 8 2 1030 1050 -52 -7 0
1 10 8 2 1030 1050 -36 -7 0
1 11 3 1 1040 1070 -6 22 0
1 12 3 1 1050 1090 -40 9 0
2 13 4 2 1288 1333 83 -21 0
2 13 4 2 1288 1350 94 -6 0
2 14 5 1 1330 1380 62 9 0
2 15 3 1 1428 1458 66 -9 0
2 16 6 2 1458 1488 54 5 0
2 16 6 2 1458 1488 70 7 0
2 17 6 2 1488 1518 50 -49 0
2 17 6 2 1488 1518 49 -36 0
2 18 4 2 1505 1535 38 -19 0
2 18 4 2 1505 1535 26 -9 0
